XXXXXXXXXXXXXXXXXXXXXXXXXXXXXXXXXXXXXXX
X................................. S  X
X.#.#.#.#.#.#.#.#.#.#.#.#.#.#.#.#.#E# X
X.....................................X
X.#.#.#.#.#.#.#.#.#.#.#.#.#.#.#.#.#.#.X
X.....................................X
X.#.#.#.#.#.#.#.#.#.#.#.#.#.#.#.#.#.#.X
X.....................................X
X.#.#.#.#.#.#.#.#.#.#.#.#.#.#.#.#.#.#.X
X.....................................X
X.#.#.#.#.#.#.#.#.#.#.#.#.#.#.#.#.#.#.X
X.....................................X
X.#.#.#.#.#.#.#.#.#.#.#.#.#.#.#.#.#.#.X
X.....................................X
X.#.#.#.#.#.#.#.#.#.#.#.#.#.#.#.#.#.#.X
X.....................................X
X.#.#.#.#.#.#.#.#.#.#.#.#.#.#.#.#.#.#.X
X.....................................X
XXXXXXXXXXXXXXXXXXXXXXXXXXXXXXXXXXXXXXX
:ZZZZZZZZZZZZEELLLPPPQQQTTT
!

'S' Player start point
'P' BombPower
'Q' BombQuantity
'T' BombReloadTime
'L' Life
'Z' Zomby
' ' EmptyLand
'X' SteelWall
'#' StoneWall
'.' BrickWall

