XXXXXXXXXXXXXXXXXXXXXXXXXXXXXXXXXXXXXXX
XS           .........................X
X #.#.#.#.#.#.#.#.#.#.#.#.#.#.#.#.#.#.X
X ....................................X
X #.#.#.#.#.#.#.#.#.#.#.#.#.#.#.#.#.#.X
X ....................................X
X #.#.#.#.#.#.#.#.#.#.#.#.#.#.#.#.#.#.X
X ....................................X
X #.#.#.#.#.#.#.#.#.#.#.#.#.#.#.#.#.#.X
X.....................................X
X.#.#.#.#.#.#.#.#.#.#.#.#.#.#.#.#.#.#.X
X.....................................X
X.#.#.#.#.#.#.#.#.#.#.#.#.#.#.#.#.#.#.X
X.....................................X
X.#.#.#.#.#.#.#.#.#.#.#.#.#.#.#.#.#.#.X
X.....................................X
X.#.#.#.#.#.#.#.#.#.#.#.#.#.#.#.#.#.#.X
X.....................................X
XXXXXXXXXXXXXXXXXXXXXXXXXXXXXXXXXXXXXXX
!

'S' Player start point
' ' EmptyLand
'X' SteelWall
'#' StoneWall
'.' BrickWall

